x x x x x x x x x x x x x
x x x x x x x x x x x x x
x x x x x x x x x x x x x
x x x x x x x x x x x x x
x x x x x x x x x x x x x
x x x x x x B x x x x x x
x x x x x x x x x x x x x
x x x T x x x x x x V x x
x x x x x x S x x x x x x
x x x x x x x x x x x x x
x x x x x x x x x x x x x
x x x x x B B B x x x x x
x x x x x T O B x x x x x