x x x B x x x B x x x x x
x T x B x x x T x T x T x
x T x x x x T T x T B T x
x x x T x x x x x B x x x
S x x T x x B x x T S T B
S S x x x T x x x x S x x
x x T T S S S B x x S x B
x x x B S T x T x T x T x
B T x B x T x T x x x T x
x T x T x T T T x T B T x
x T x T x T T T x x x x x
x T x x x T T T x T x T x
x T x T x T O T x T T T x