x x x x T x x x T x x x x
x S S S T x x x x x B B B
T S S S x x x x x x x x x
S S S S x x x T x T T T T
S S S S T T T T x T x x T
S S S S x x T x x x x T x
x S x x x x B B B x x S x
x T x T x x x x x S S S S
T x T T T x T T T S S S S
x x x x T x x x x S S S S
T x x B x x x T T S S S x
T T x B x T T T x S S S x
B T T x x T O T x T x x x