x x x B B x x B B x x x x
x x B B x x x x x x B x x
x x B x x x S x B B B x x
x x B x x S B x x x B x x
x B x x S B B x x x B B x
x x x S B B B x B x x x x
B x x B B x x x B B x x x
x x x x B x B B B x x B x
x x B x x x B B S x B B x
x B B x x x B S x B B x x
x x x B x x S x x B x x B
x x x x x S S S x x x x x
B B x x x S O S x x x x x